F 45,33,37
NO     textures/simonkraft/talai.xpm
SO textures/simonkraft/talai.xpm

EA textures/simonkraft/talai.xpm

C 255,2,1
WE textures/simonkraft/talai.xpm


111111111111111
1111100000011111
11110000001111
111001000000111
11001D0000111111
1000011111000001
110000111000011
1110000W0000111
111100000001111
111110000011111
111111000111111
111111111111111