F 45,33,37
NO     textures/simonkraft/7ila9a.xpm
SO textures/simonkraft/7ila9a.xpm

EA textures/simonkraft/7ila9a.xpm

C 2,2,55
WE textures/simonkraft/7ila9a.xpm


111111111111111
1111100000011111
11110000001111
111001000000111
11001D0000111111
1000011111000001
110000111000011
111000W0000111
111100000001111
111110000011111
111111000111111
111111111111111