NO textures/simonkraft/wet_sponge.xpm
SO textures/simonkraft/wet_sponge.xpm
WE textures/simonkraft/wet_sponge.xpm
EA textures/simonkraft/wet_sponge.xpm

F 164,169,20
C 153,204,255

11111111111111111111
10000000000000000001
10000000000000000001
10000000000000000001
10000010000000000001
10000000000000000001
10000000000000000001
10000000000000000001
10000010000000000001
10000000000000000001
10000000000000000001
10000000000000000001
10000010000000000001
10000000000000000001
10000000000000000001
10000000000000000001
10000010000000000001
10000000000000000001
10000000000000000001
10000000000000000001
10000010000000000001
10000000000000000001
10000000000000000001
10000000000000000001
10000010000000000001
10000000000000000001
10000000000000000001
10000000000000000001
10000010000000000001
10000000000000000001
10000000000000000001
10000000000000000001
10000010000000000001
10000000000000000001
10000000000000000001
10000000000000000001
10000010000000000001
10000000000000000001
10000000000000000001
10000000000000000001
10000010000000000001
10000000000000000001
10000000000000000001
10000000000000000001
10000010000000000001
10000000000000000001
10000000000000000001
10000000000000000001
10000010000000000001
10000000000000000001
10000000000000000001
10000000000000000001
10000010000000000001
10000000000000000001
10000000000000000001
10000000000000000001
10000010000000000001
10000000000000000001
10000000000000000001
10000000000000000001
10000010000000000001
10000000000000000001
10000000000000000001
10000000000000000001
10000010000000000001
10000000000000000001
10000000000000000001
10000000000000000001
10000010000000000001
10000000000000000001
10000000000000000001
10000000000000000001
10000010000000000001
10000000000000000001
10000000000000000001
10000000000000000001
10000010000000000001
10000000000000000001
10000000000000000001
10000000000000000001
10000010000000000001
10000000000000000001
10000000000000000001
10000000000000000001
10000010000000000001
10000000000000000001
10000000000000000001
10000000000000000001
10000010000000000001
10000000000000000001
10000000000000000001
10000000000000000001
10000010000000000001
10000000000000000001
10000000000000000001
10000000000000000001
10000010000000000001
10000000000000000001
10000000000000000001
10000000000000000001
10000010000000000001
10000000000000000001
10000000000000000001
10000000000000000001
10000010000000000001
10000000000000000001
10000000000000000001
10000000000000000001
10000010000000000001
10000000000000000001
10000000000000000001
10000000000000000001
10000010000000000001
10000000000000000001
10000000000000000001
10000000000000000001
10000010000000000001
10000000000000000001
10000000000000000001
10000000000000000001
10000010000000000001
10000000000000000001
10000000000000000001
10000000000000000001
10000010000000000001
10000N01000000000001
10000000000000000001
11111111111111111111
