NO textures/simonkraft/talai.xpm
SO textures/simonkraft/talai.xpm
WE textures/simonkraft/talai.xpm
EA textures/simonkraft/talai.xpm

F 255,0,0
C 138,0,0


11111111111111111111
10100000000000000001
10100000000000000001
10100N00F00000000001
10100000000000000001
10100000000000000001
10100000000000000001
10100000000000000001
10100000000000000001
10100000000000000001
10100000000000000001
10100000000000000001
11111111111111111111
