NOtextures/simonkraft/hitler.xpm
SOtextures/simonkraft/hitler.xpm
WEtextures/simonkraft/hitler.xpm
EAtextures/simonkraft/hitler.xpm
DOtextures/simonkraft/door.xpm

F0,0,0
C0,0,0
        1111111111111111111111111
        1000000000110000000000001
        1011000001110000000000001
        1001000000000000000000001
111111111011000001110000000000001
100000000011000001110111111111111
11110111111111011100000010001
11110111111111011101010010001
11000000111101011100000010001
1000000000D000N01100000010001
10000000001000001101010010001
11000001110101011111011110001
11110111 1110101 101111010001
11111111 1111111 111111111111
F0,0,0
C0,0,0